111111111111
11111X111011
100000001011
111111101011
111111100011
111111101111
111111111111
100000001111
1111011Y1111
111111111111